     AAAAAAAAAAAAAAAAAAAAAAAAAAA
       BBBA            b        
BBB    AAAA           AAA       
AABBB     A     b               
     B   BA    AAA           b  
A         A                 AAA 
AAB   AAAAA                     
BBBA  BB BA      b b            
BBB B  AA A    AAAAAAA          
A         A                     
BBBBBBB  AA                     
          A                     
B   BBBBAAA                b    
BB       AA              AAAAA  
AAAAAA   AA                     
BB      ABA                     
BBB BBAAAAAAAAAAAAAABAABABAAAABB
A         AAAAAABbBAAABbBAAABbBA
BBB AA  AAAAAAAAAAAAAAAAAAABAAAA
AAAAAAANAAAAAAAAAAAAAAAAAAAAAAAA